sweet rolls	cheese,cinnamon,commercially prepared with raisins,refrigerated dough with frosting,baked
muffin	blueberry,commercially prepared,low fat
murray	sugar free,vanilla sugar wafer,chocolatey chip thins cookies,cookie jar classics,coconut bars cookies,duplex creme sandwich cookies,lemon creme sandwich cookies,jacks vanilla wafers,old fashioned iced oatmeal cookies,southern kitchen,chocolate chip cookies,coconut cookies,iced oatmeal cookies,chocolate bites cookies,chocolate chip & pecan cookies,fudge dipped grahams,fudge dipped mint cookies,fudge dipped wafers,peanut butter cookies,pecan shortbread cookies,vanilla creme sandwich cookies,shortbread cookies,shortbread bites,vanilla wafer,butter cookies,chocolate creme sandwich cookies,honey graham,old fashioned gingersnaps cookies,oatmeal cookies
puff pastry	frozen,ready to bake,baked
kraft foods	shake 'n' bake original recipe,coating for pork,dry
eclairs	custard filled with chocolate glaze,prepared from recipe
bagels	plain,enriched,with calcium propionate,toasted,egg,cinnamon raisin,oat bran,without calcium propionate,unenriched
kellogg's	eggo,waffles,homestyle,low fat,nutri grain,beanatural,original three bean chips,biscuit scramblers,bacon,egg & cheese,french toaster sticks,cinnamon,original,mini muffin tops,blueberry,chocolate chip,nutri grain frozen fruit pizza,mixed berry granola,strawberry granola,pancakes,cinnabon,caramel,wafflers,brown sugar cinnamon roll,strawberry strudel,buttermilk,cinnamon toast,fiberplus waffles,french toast,eggo protein,honey oat,eggo seasons,pumpkin spice,simply eggo,strawberry,thick & fluffy,brown sugar,all bran,garlic and herb crackers,multigrain crackers,corn flakes crumbs,pop tarts,frosted apple strudel toaster pastries,frosted blueberry muffin toaster pastries,chocolate chip cookie dough toaster pastries,frosted cinnamon roll toaster pastries,frosted confetti cake toaster pastries,frosted cookies & creme toaster pastries,frosted orange cream toaster pastries,frosted pumpkin pie toaster pastries,frosted spring berry toaster pastries,frosted sugar cookie toaster pastries,frosted waffle cone toaster pastries,frosted wild fruit fusion toaster pastries,frosted wild grape toaster pastries,frosted wild strawberry toaster pastries,ice cream shoppe frosted hot fudge sundae toaster pastries,ice cream shoppe frosted ice creme sandwich toaster pastries,ice cream shoppe frosted rainbow chip toaster pastries,ice cream shoppe frosted strawberry milkshake toaster pastries,ice cream shoppe frosted vanilla milkshake toaster pastries,pop tarts mini crisps,cinnamon brown sugar baked bites,frosted chocolate baked bites,frosted strawberry baked bites,special k,cracker chips,cheddar,sea salt,sour cream & onion,southwest ranch,savory herb crackers,gingerbread toaster pastries,yum azing vanilla milkshake toaster pastries,eggo minis
focaccia	italian flatbread,plain
cream puff	eclair,custard or cream filled,iced
pancakes plain	frozen,ready to heat
cracker meal	
keikitos	latino bakery item
interstate brands corp	wonder hamburger rolls
kashi h twoh woven wheat cracker roasted garlic	
kellogg	kellogg's eggo,buttermilk pancake,kellog's nutri grain cereal bars,mixed berry
martha white foods	martha white's chewy fudge brownie mix,dry,martha white's buttermilk biscuit mix
bear naked	double chocolate cookies,fruit & nut cookies
bread	banana,prepared from recipe,made with margarine,boston brown,canned,cornbread,dry mix,enriched,prepared,made with low fat  milk,cracked wheat,egg,toasted,french or vienna,irish soda,italian,multi grain,oat bran,oatmeal,pita,white,whole wheat,protein,pumpernickel,raisin,reduced calorie,rye,wheat,rice bran,wheat bran,wheat germ,commercially prepared,made with nonfat dry milk,unenriched,low sodium no salt,salvadoran sweet cheese,pound cake type,pan de torta salvadoran,pan dulce,sweet yeast bread,white wheat,potato,cheese
kashi blueberry waffle	
coffeecake	cheese,cinnamon with crumb topping,commercially prepared,enriched,creme filled with chocolate frosting,fruit,dry mix,prepared,unenriched
tortillas	ready to bake or  fry,corn,flour,refrigerated,without added salt,without added calcium,shelf stable
wonton wrappers	
mckee baking	little debbie nutty bars,wafers with peanut butter,chocolate covered
cheesecake prepared from mix	no bake type
bread crumbs	dry,grated,plain,seasoned
continental mills	krusteaz almond poppyseed muffin mix,artificially flavored,dry
biscuits	plain or buttermilk,frozen,baked,dry mix,prepared,refrigerated dough,lower fat,higher fat,prepared from recipe,mixed grain
kashi h twoh woven wheat cracker original	
cheesecake commercially prepared	
cookies	animal crackers,brownies,commercially prepared,dry mix,regular,prepared from recipe,butter,enriched,fudge,cake type,chocolate wafers,chocolate chip,lower fat,higher fat,soft type,refrigerated dough,baked,made with margarine,chocolate sandwich,with creme filling,chocolate coated,with extra creme filling,coconut macaroons,fig bars,fortune,gingersnaps,graham crackers,plain or honey,ladyfingers,with lemon juice and rind,marshmallow,molasses,oatmeal,with raisins,peanut butter,peanut butter sandwich,raisin,shortbread,plain,pecan,special dietary,prepared,sugar wafers with creme filling,sugar,vanilla sandwich with creme filling,vanilla wafers,without raisins,made with butter,unenriched,without lemon juice and rind,fat free
heinz	weight watcher,chocolate eclair,frozen
popovers	dry mix,enriched,unenriched
breakfast tart	low fat
waffle	buttermilk,frozen,ready to heat,toasted,microwaved,plain,microwave
pillsbury grands	buttermilk biscuits,refrigerated dough
kashi original waffle	
general mills	betty crocker supermoist yellow cake mix,dry
garlic bread	frozen
cream puffs	prepared from recipe,shell,with custard filling
usda commodity	bakery,flour mix,flour mix low fat
artificial blueberry muffin mix	dry
croutons	plain,seasoned
kellogg's eggo lowfat blueberry nutri grain waffles	
pancakes	plain,dry mix,complete,prepared,incomplete,prepared from recipe,blueberry,buckwheat,special dietary,whole wheat,buttermilk,frozen,ready to heat,microwave
pan dulce	la ricura,salpora de arroz con azucar,cookie like,contains wheat flour and rice flour
english muffins	plain,enriched,with ca prop,toasted,with calcium propionate,mixed grain,raisin cinnamon,wheat,whole wheat,without calcium propionate,unenriched
toaster pastries	brown sugar cinnamon,fruit,kellogg,kellogg's pop tarts,blueberry,frosted blueberry,frosted brown sugar cinnamon,frosted cherry,frosted chocolate fudge,frosted raspberry,s'mores,strawberry,frosted strawberry,frosted wild berry,kellogg's low fat pop tarts,frosted,toasted
strudel	apple
french toast	frozen,ready to heat,prepared from recipe,made with low fat  milk
austin	cheddar cheese on wheat crackers,sandwich type,cheddar cheese on cheese crackers,chocolatey peanut butter crackers,grilled cheese on wafer crackers,reduced fat,peanut butter on cheese crackers,peanut butter on toasty crackers,pb & j crackers,cheddar cheese on wafer crackers
kashi tlc crackers honey sesame	
bread stuffing	bread,dry mix,prepared,cornbread
pillsbury	buttermilk biscuits,artificial flavor,refrigerated dough,chocolate chip cookies,crusty french loaf,traditional fudge brownie mix,dry,cinnamon rolls with icing
taco shells	baked,without added salt
doughnuts	cake type,plain,chocolate coated or frosted,sugared or glazed,chocolate,wheat,french crullers,glazed,yeast leavened,with creme filling,enriched,with jelly filling,unenriched
phyllo dough	
famous amos	chocolate chip cookies,chocolate chip pecan cookies,chocolate sandwich creme cookies,vanilla sandwich creme cookies
rolls	dinner,plain,commercially prepared,egg,oat bran,rye,wheat,whole wheat,french,hamburger or hotdog,mixed grain,reduced calorie,hard,prepared from recipe,made with low fat  milk,pumpernickel
hush puppies	prepared from recipe
cinnamon buns	frosted
cake mix	angelfood,dry,pudding,german chocolate,white,regular
nabisco	nabisco grahams crackers,nabisco oreo crunchies,cookie crumb topping,nabisco ritz crackers,nabisco snackwell's fat free devil's food cookie cakes
sunshine	cheez it,asiago crackers,baby swiss crackers,big crackers,cheddar jack crackers,colby crackers,duoz sharp cheddar parmesan crackers,duoz smoked cheddar monterey jack crackers,gripz,cheez it crackers,cheez it mixx and cheesy pizza crackers,hot & spicy crackers,italian four cheese crackers,crackers,mozzarella crackers,parmesan garlic crackers,pepper jack crackers,white cheddar,reduced fat crackers,one hundred calorie right bites,extra cheesy party mix,reduced fat,scrabble jr. crackers,snack mix,original crackers,krispy,soup & oyster crackers
barbara dee	winter mints cookies
jackson's	old fashioned lemon jumble cookies,old fashioned vanilla wafers
pie crust	cookie type,prepared from recipe,graham cracker,baked,standard type,dry mix,prepared,frozen,ready to bake,enriched,chocolate wafer,chilled,vanilla wafer,unbaked,unenriched,ready crust,chocolate,deep dish,made with enriched flour,refrigerated,regular
kraft	stove top stuffing mix chicken flavor
kashi	tlc,original seven grain crackers,toasted asiago crackers,fire roasted vegetable crackers,pita crisps,sea salt,zesty salsa,happy trail mix cookies,oatmeal dark chocolate cookies,oatmeal raisin flax cookies,honey sesame crackers
pillsbury golden layer buttermilk biscuits	artificial flavor,refrigerated dough
cake	angelfood,commercially prepared,dry mix,prepared,boston cream pie,carrot,pudding type,cherry fudge with chocolate frosting,chocolate,commercially prepared with chocolate frosting,in store bakery,regular,prepared from recipe without frosting,white,prepared from recipe with coconut frosting,fruitcake,gingerbread,prepared from recipe,marble,pineapple upside down,pound,butter,other than all butter,enriched,shortcake,biscuit type,snack cakes,creme filled,chocolate with frosting,sponge,special dietary,yellow,with chocolate frosting,with vanilla frosting,unenriched,fat free,cupcakes,with frosting,low fat,light,bimbo bakeries usa,panque casero,home baked style
crackers	cheese,regular,sandwich type with peanut butter filling,crispbread,rye,matzo,plain,egg,whole wheat,melba toast,wheat,milk,rusk toast,sandwich type with cheese filling,wafers,seasoned,saltines,standard snack type,sandwich,with cheese filling,with peanut butter filling,egg and onion,without salt,low salt,unsalted tops,low sodium,fat free,reduced fat,snack,goya crackers,cream,gamesa sabrosas,la moderna rikis cream crackers
mission foods	mission flour tortillas,soft taco,eight inch
pie	apple,commercially prepared,enriched flour,prepared from recipe,banana cream,prepared from mix,no bake type,blueberry,cherry,chocolate creme,chocolate mousse,coconut creme,coconut cream,coconut custard,egg custard,fried pies,fruit,lemon meringue,mince,peach,pecan,pumpkin,vanilla cream,unenriched flour,lemon,dutch apple
pastry	pastelitos de guava
muffins	plain,prepared from recipe,made with low fat  milk,blueberry,commercially prepared,dry mix,toaster type,corn,prepared,oat bran,wheat bran,toaster type with raisins,toasted
george weston bakeries	brownberry sage and onion stuffing mix,dry,thomas english muffins
keebler	keebler chocolate graham selects,vanilla wafers,animals,cookies,frosted cookies,iced cookies,crackers,baker's treasures,chocolate chip cookie,soft,oatmeal raisin cookie,cheese & cheddar sandwich crackers,club & cheddar sandwich crackers,cheese on wheat sandwich crackers,chips deluxe,chocolate lovers cookies,chocolate malt chunk cookies,coconut cookies,dark chocolate chunk cookies,mini chocolate chip cookies,oatmeal chocolate chip cookies,original chocolate chip cookies,peanut butter cups cookies,rainbow chocolate chip cookies,bite size,soft 'n chewy chocolate chip cookies,club,buttery garlic crackers,dash of salt crackers,minis original crackers,minis multigrain crackers,multigrain crackers,original crackers,reduced fat crackers,club crackers,snack sticks,honey wheat,original,country style oatmeal cookies with raisins,danish wedding cookies,e.l. fudge,butter flavored cookies,double stuffed cookies,fudge shoppe,cheesecake middles,dark chocolate,original graham cookies,mint creme middles,chocolate graham cookies,coconut dreams cookies,deluxe grahams cookies,caramel filled cookies,peanut creme filled cookies,triple fudge filled cookies,fudge dipped ice cream cups,fudge grahams,one/two dipped,reduced fat,fudge sticks,fudge stripes,holiday/spiderman,mini,oatmeal,grasshopper cookies,fudge mint,jumbo fudge sticks,vanilla,peanut butter,magic middles fudge filled cookies,merry mint patties,holiday,mint,cinnamon toast grahams,gripz,chocolate chip cookies,chocolate chip grahams,cinnamon grahams,almond crescents cookies,gingerbread men cookies,holiday jingles cookies,iced oatmeal cookies,toast & peanut butter sandwich crackers,ready crust,chocolate pie crust,shortbread pie crust,one hundred calorie right bites,dark chocolate fudge stripes cookies,fudge covered pretzels,cookies 'n creme,mini brownies,mini fudge grahams cookies,mini fudge stripes cookies,mini mints grasshopper cookies,sandies shortbread cookies,fudge dipped,white fudge dipped pretzels,sandies,cashew shortbread cookies,chocolate chip & pecan shortbread cookies,dark chocolate almond shortbread cookies,pecan shortbread cookies,soft batch,sweet cremes cookies,toasted coconut cookies,toasteds,buttercrisps crackers,party pack cracker assortment,onion crackers,sesame crackers,wheat crackers,town house,bistro multigrain crackers,flipsides,pretzel crackers,cheese,garlic herb,toppers,garlic herb crackers,flatbread crisps,sea salt and olive oil crackers,traditions,iced lemonade cookies,vanilla wafers minis,rainbow,vienna fingers with creme filling,waffle bowls,waffle cones,wheatables,honey wheat crackers,nut crisp crackers,roasted almond,toasted pecan,zesta,export sodas crackers,grahams,cinnamon crisp,oatmeal cookies,cheese & peanut butter sandwich crackers,graham pie crust,simply shortbread cookies,sugar cones,saltines,saltines with whole wheat
girl scouts	caramel dulce de leche cookies,chalet cookies,do si dos cookies,samoas cookies,tagalongs cookies,thank u berry munch cookies,thin mints cookies,trefoils cookies
waffles	plain,frozen,ready to heat,prepared from recipe,ready  to heat,toasted,buttermilk,chocolate chip
bagel	wheat
tostada shells	corn
archway home style cookies	sugar free oatmeal,chocolate chip ice box,coconut macaroon,date filled oatmeal,dutch cocoa,frosty lemon,iced molasses,iced oatmeal,molasses,oatmeal,oatmeal raisin,old fashioned molasses,old fashioned windmill cookies,peanut butter,raspberry filled,strawberry filled,reduced fat ginger snaps
leavening agents	baking powder,double acting,sodium aluminum sulfate,straight phosphate,low sodium,baking soda,cream of tartar,yeast,baker's,compressed,active dry
croissants	butter,apple,cheese
ice cream cones	cake or wafer type,sugar,rolled type
mother's	fourth of july circus animal cookies,chocolate chip cookies,circus animal cookies,coconut cocadas cookies,double fudge creme sandwich cookies,english tea sandwich cookies,halloween circus animals cookies,holiday circus animal cookies,iced lemonade cookies,iced oatmeal cookies,jungle animal cookies,macaroon cookies,old fashioned chocolate chip cookies,old fashioned iced oatmeal cookies,peanut butter gauchos cookies,taffy sandwich cookies,old fashioned oatmeal cookies,vanilla sandwich cookies
danish pastry	cinnamon,enriched,cheese,fruit,nut,unenriched,lemon,raspberry
bread sticks	plain
