pineapple and grapefruit juice drink	canned
fruit flavored drink	less than three percent juice,not fortified with vitamin c,reduced sugar,greater than three percent fruit juice,high vitamin c,added calcium,dry powder,low calorie,with high vitamin c,dry powdered mix,with aspartame,powder,with high vitamin c with other added vitamins
grape drink	canned
energy drink	red bull,with added caffeine,niacin,pantothenic acid,vitamins b six and b twelve,sugar free,amp,full throttle,monster,rockstar,vault,citrus flavor,vault zero
tea	ready to drink,nestle,cool nestea ice tea lemon flavor,black,brewed,prepared with tap water,decaffeinated,instant,unsweetened,powder,sweetened with non nutritive sweetener,lemon flavored,sweetened with sugar,without added ascorbic acid,prepared,sweetened with sodium saccharin,sweetened with sweetened with non nutritive sweetener,herb,other than chamomile,arizona iced tea,with lemon flavor,lipton brisk iced tea,prepared with distilled water,chamomile,with added ascorbic acid,wendy's,fast food,without ice
mixed vegetable and fruit juice drink	with added nutrients
lemonade	powder,prepared with water,low calorie,with non nutritive sweetener,frozen concentrate,white,pink
carbonated beverage	club soda,cream soda,ginger ale,grape soda,low calorie,other than cola or pepper,without caffeine,lemon lime soda,contains caffeine,sprite,lemon lime,cola or pepper type,with aspartame,cola,with higher caffeine,reduced sugar,contains caffeine and sweeteners,orange,pepper type,tonic water,root beer,cola or pepper types,with sodium saccharin,chocolate flavored soda
orange juice drink	
meal supplement drink	nestle,supligen,canned,peanut flavor
malted drink mix	natural,with added nutrients,powder,prepared with whole milk,chocolate
chocolate flavor beverage mix	powder,prepared with whole milk
shake	fast food,chocolate,vanilla,strawberry
vegetable and fruit juice drink	reduced calorie,with low calorie sweetener,added vitamin c
fruit punch juice drink	frozen concentrate,prepared with water
hibiscus tea	
pineapple and orange juice drink	canned
chocolate flavored drink	whey and milk based
fruit punch flavor drink	powder,without added sodium,prepared with water
cranberry grape juice drink	bottled
rice drink	unsweetened,with added calcium,vitamins a and d
cranberry juice cocktail	bottled,low calorie,with calcium,saccharin and corn sweetener,frozen concentrate,prepared with water
grape juice drink	canned
v eight splash smoothies	peach mango,strawberry banana,tropical colada
water with added vitamins and minerals	bottles,sweetened,assorted fruit flavors
quaker oats	propel fitness water,fruit flavored,non carbonated
v eight splash juice drinks	diet berry blend,diet fruit medley,diet strawberry kiwi,diet tropical blend,berry blend,fruit medley,guava passion fruit,mango peach,orange pineapple,orchard blend,strawberry banana,strawberry kiwi,tropical blend
malt beverage	includes non alcoholic beer
beverages	vegetable and fruit juice blend,one hundred percent juice,with added vitamins a,c,e,fruit juice drink,reduced sugar,with vitamin e added
ready to drink reduced fat milk beverage	flavored and sweetened,with added calcium,vitamin a and vitamin d
coffee and cocoa  powder	with whitener and low calorie sweetener,decaffeinated
dairy drink mix	chocolate,reduced calorie,with low calorie sweeteners,powder,with aspartame,prepared with water and ice
clam and tomato juice	canned
strawberry flavor beverage mix	powder,prepared with whole milk
coffee	brewed from grounds,prepared with tap water,decaffeinated,brewed,espresso,restaurant prepared,instant,regular,powder,half the caffeine,prepared with water,with chicory,with sugar,mocha flavor,cappuccino flavor powder,french flavor,dry,with whitener,reduced calorie
sports drink	fruit flavored,low calorie,ready to drink,pepsico quaker gatorade,gatorade,original,ready to drink. now called “g performance o 2”.,coca cola,powerade,lemon lime flavored,powerade zero ion four,calorie free,assorted flavors,gatorade g two
drink mix	quaker oats,gatorade,orange flavor,powder
beef broth and tomato juice	canned
carob flavor beverage mix	powder,prepared with whole milk
alcoholic beverage	beer,regular,all,budweiser,light,budweiser select,bud light,daiquiri,canned,prepared from recipe,michelob ultra,pina colada,tequila sunrise,whiskey sour,prepared with water,whiskey and powder mix,prepared from item fourteen thousand and twenty-eight,creme de menthe,seventy-two proof,distilled,all  eighty proof,gin,ninety proof,rum,eighty proof,vodka,whiskey,eighty-six proof,wine,dessert,sweet,table,red,cabernet sauvignon,cabernet franc,pinot noir,syrah,barbera,zinfandel,petite sirah,claret,white,lemberger,sangiovese,carignane,pinot gris,chenin blanc,fume blanc,muller thurgau,gewurztraminer,late harvest,semillon,riesling,sauvignon blanc,pinot blanc,muscat,burgundy,gamay,mouvedre,chardonnay,liqueur,coffee,fifty-three proof,coffee with cream,thirty-four proof,prepared from item fourteen thousand,five hundred and thirty,all  ninety-four proof,all  one hundred proof,sixty-three proof,dry,all  eighty-six proof,all  ninety proof,merlot,cooking,rice
chocolate syrup	prepared with whole milk
coffee substitute	cereal grain beverage,powder,prepared with water,prepared with whole milk
v eight v. fusion juices	peach mango,strawberry banana,tropical,acai berry
fruit juice drink	greater than three percent fruit juice,high vitamin c and added thiamin,greater than three percent juice,high vitamin c
lemonade flavor drink	powder,prepared with water
orange and apricot juice drink	canned
cocoa mix	powder,prepared with water,nestle,hot cocoa mix rich chocolate with marshmallows,no sugar added,rich chocolate hot cocoa mix,with aspartame,low calorie,with added calcium phosphorus,without added sodium or vitamin a
fruit flavored drink containing less than three percent fruit juice	with high vitamin c
water	bottled,perrier,poland spring,tap,drinking,well,municipal,non carbonated,dannon,pepsi,aquafina,dasani,calistoga,crystal geyser,naya,dannon fluoride to go,generic,evian,bottles,natural fruit flavors,sweetened with low calorie sweetener,with corn syrup and/or sugar and low calorie sweetener,fruit flavored
cocktail mix	non alcoholic,concentrated,frozen
orange breakfast drink	ready to drink,with added nutrients
citrus fruit juice drink	frozen concentrate,prepared with water
fruit punch drink	without added nutrients,canned,with added nutrients,frozen concentrate,prepared with water
orange flavor drink	breakfast type,powder,prepared with water,low calorie,with pulp,frozen concentrate
chocolate flavor beverage mix for milk	powder,without added nutrients,with added nutrients,prepared with whole milk
eggnog flavor mix	powder,prepared with whole milk
beverage	horchata,dry mix,unprepared,variety of brands,all with morro seeds,as served in restaurant
wine	non alcoholic
cranberry apple juice drink	bottled,low calorie,with vitamin c added
whiskey sour mix	powder,bottled,with added potassium and sodium
orange drink	canned,with added vitamin c,breakfast type,with juice and pulp,frozen concentrate,prepared with water
limeade	frozen concentrate,prepared with water
cranberry apricot juice drink	bottled
