silk plain	soymilk
morningstar farms california turk'y burger	frozen,unprepared
silk nog	soymilk
silk blueberry soy yogurt	
mori nu	tofu,silken,soft,firm,extra firm,lite firm,lite extra firm
morningstar farms veggie italian style sausage	frozen,unprepared
loma linda little links	canned,unprepared
silk vanilla soy yogurt	
vegetarian fillets	
chicken	meatless,breaded,fried
morningstar farms lasagna with veggie sausage	frozen,unprepared
morningstar farms chik patties	frozen,unprepared
morningstar farms asian veggie patties	frozen,unprepared
silk strawberry soy yogurt	
loma linda vege burger	canned,unprepared
hyacinth beans	mature seeds,raw,cooked,boiled,without salt,with salt
worthington meatless corned beef roll	frozen,unprepared
silk plain soy yogurt	
worthington multigrain cutlets	canned,unprepared
silk light plain	soymilk
chickpeas	mature seeds,raw,cooked,boiled,without salt,canned,solids and liquids,with salt,drained solids,drained,rinsed in tap water\
silk unsweetened	soymilk
morningstar farms chik'n grill veggie patties	frozen,unprepared
morningstar farms chik'n nuggets	frozen,unprepared
vitasoy usa organic nasoya	soft tofu,tofu plus extra firm,tofu plus firm
okara	
worthington prosage roll	frozen,unprepared
chili with beans	canned
green giant	harvest burger,original flavor,all vegetable protein patties,frozen
frijoles rojos volteados	
refried beans	canned,traditional style,vegetarian,fat free
worthington veja links	canned,unprepared
vitasoy usa organic nasoya sprouted	tofu plus super firm
mothbeans	mature seeds,raw,cooked,boiled,without salt,with salt
loma linda redi burger	canned,unprepared
mung beans	mature seeds,raw,cooked,boiled,without salt,with salt
morningstar farms grillers vegan	frozen,unprepared
soy sauce made from soy and wheat	low sodium
pigeon peas	mature seeds,raw,cooked,boiled,without salt,with salt
morningstar farms veggie breakfast sausage patties	frozen,unprepared
fish sticks	meatless
house foods premium soft tofu	
loma linda tender rounds with gravy	canned,unprepared
soy protein isolate	protein technologies international,supro,proplus,potassium type,crude protein basis
morningstar farms bbq riblets	frozen,unprepared
worthington dinner roast	frozen,unprepared
lupins	mature seeds,raw,cooked,boiled,without salt,with salt
worthington vegetable skallops	canned,unprepared
silk banana strawberry soy yogurt	
morningstar farms meal starters chik'n strips	frozen,unprepared
worthington low fat veja links	canned,unprepared
morningstar farms veggie breakfast sausage links	frozen,unprepared
morningstar farms entree chik'n enchilada with rice	frozen,unprepared
bacon	meatless
silk coffee	soymilk
morningstar farms spicy black bean burger	frozen,unprepared
frankfurter	meatless
falafel	home prepared
noodles	chinese,cellophane or long rice,dehydrated
vitasoy usa azumaya	extra firm tofu,firm tofu,silken tofu
silk vanilla	soymilk
veggie burgers or soyburgers	unprepared
lentils	raw,mature seeds,cooked,boiled,without salt,pink,with salt
peanut butter with omega three	creamy
worthington frichik original	canned,unprepared
meatballs	meatless
soy sauce made from hydrolyzed vegetable protein	
morningstar farms grillers prime	frozen,unprepared
morningstar farms breakfast pattie made with organic soy	frozen,unprepared
worthington vegetable steaks	canned,unprepared
usda commodity	peanut butter,smooth
silk chai	soymilk
morningstar farms sausage style recipe crumbles	frozen,unprepared
soy flour	full fat,raw,roasted,defatted,low fat,crude protein basis
morningstar farms hot and spicy veggie sausage patties	frozen,unprepared
soy protein concentrate	produced by alcohol extraction,produced by acid wash,crude protein basis
loma linda low fat big franks	canned,unprepared
peas	split,mature seeds,raw,cooked,boiled,without salt,with salt
soy meal	defatted,raw,crude protein basis
silk mocha	soymilk
morningstar farms garden veggie patties	frozen,unprepared
worthington chili	canned,unprepared
worthington low fat fri chik	canned,unprepared
soymilk	original and vanilla,unfortified,with added calcium,vitamins a and d,chocolate,unsweetened,enhanced,light,chocolate and other flavors,lowfat,nonfat
worthington prosage links	frozen,unprepared
mungo beans	mature seeds,raw,cooked,boiled,without salt,with salt
peanut flour	defatted,low fat
yardlong beans	mature seeds,raw,cooked,boiled,without salt,with salt
hummus	home prepared,commercial
beans	adzuki,mature seeds,raw,cooked,boiled,without salt,canned,sweetened,yokan,baked,home prepared,plain or vegetarian,with beef,with franks,with pork,with pork and sweet sauce,with pork and tomato sauce,black,black turtle,cranberry,french,great northern,kidney,all types,california red,red,solids and liquids,royal red,navy,pink,pinto,small white,yellow,white,drained solids,mature seed,with salt,rinsed in tap water,boiled with salt,chili,barbecue,ranch style,liquid from stewed kidney beans,no salt added
peanut spread	reduced sugar
worthington prime stakes	canned,unprepared
vitasoy usa	nasoya lite firm tofu,organic nasoya super firm cubed tofu,organic nasoya extra firm tofu,organic nasoya firm tofu,organic nasoya silken tofu,vitasoy organic creamy original soymilk,vitasoy organic classic original soymilk,vitasoy light vanilla soymilk
papad	
peanut butter	chunk style,with salt,smooth style,smooth,reduced fat,vitamin and mineral fortified,chunky,without salt,reduced sodium
broadbeans	mature seeds,raw,cooked,boiled,without salt,canned,with salt
miso	
silk peach soy yogurt	
soybeans	mature seeds,raw,mature cooked,boiled,without salt,roasted,salted,dry roasted,cooked,with salt,no salt added
worthington vegetarian burger	canned,unprepared
tofu	firm,prepared with calcium sulfate and magnesium chloride,soft,dried frozen,fried,salted and fermented,extra firm,prepared with nigari,hard,raw,prepared with calcium sulfate,regular
ensure fiber with fos	liquid
vitasoy usa nasoya	lite silken tofu
soybean	curd cheese
silk plus fiber	soymilk
morningstar farms grillers quarter pound veggie burger	frozen,unprepared
morningstar farms tomato & basil pizza burger	frozen,unprepared
campbell's brown sugar and bacon flavored baked beans	
morningstar farms bacon	egg & cheese biscuit,frozen,unprepared
vegetarian meatloaf or patties	
natto	
silk raspberry soy yogurt	
vegetarian stew	
morningstar farms grillers burger style recipe crumbles	frozen,unprepared
worthington diced chik	canned,unprepared
silk light vanilla	soymilk
worthington stakelets	frozen,unprepared
morningstar farms mushroom lover's burger	frozen,unprepared
loma linda linketts	canned,unprepared
silk light chocolate	soymilk
morningstar farms mini veggie corn dogs	frozen,unprepared
lima beans	large,mature seeds,raw,cooked,boiled,without salt,canned,thin seeded,with salt
morningstar farms veggie corn dogs	frozen,unprepared
peanuts	all types,raw,cooked,boiled,with salt,oil roasted,dry roasted,spanish,valencia,virginia,without salt
bean beverage	
silk original creamer	
morningstar farms meatfree buffalo wings	frozen,unprepared
morningstar farms original chik'n tenders	frozen,unprepared
loma linda swiss stake with gravy	canned,unprepared
silk black cherry soy yogurt	
tempeh	cooked
soy sauce made from soy	
pace	traditional refried beans,salsa refried beans,spicy jalapeno refried beans
morningstar farms sesame chik'n entree	frozen,unprepared
silk key lime soy yogurt	
worthington meatless chicken roll	frozen,unprepared
silk plus for bone health	soymilk
silk french vanilla creamer	
silk hazelnut creamer	
morningstar farms veggie sweet and sour chik'n	frozen,unprepared
silk chocolate	soymilk
worthington stripples	frozen,unprepared
silk very vanilla	soymilk
campbell's pork and beans	
worthington chic ketts	frozen,unprepared
worthington fripats	frozen,unprepared
bacon bits	meatless
cowpeas	catjang,mature seeds,raw,cooked,boiled,without salt,common,canned,plain,canned with pork,with salt
morningstar farms italian herb chik patties	frozen,unprepared
worthington leanies	frozen,unprepared
morningstar farms veggie breakfast bacon strips	frozen,unprepared
worthington smoked turkey roll	frozen,unprepared
carob flour	
worthington saucettes	canned,unprepared
morningstar farms grillers original	frozen,unprepared
loma linda tender bits	canned,unprepared
vermicelli	made from soy
worthington super links	canned,unprepared
sausage	meatless
meat extender	
morningstar farms maple flavored veggie sausage patties	frozen,unprepared
gardenburger	black bean chipotle burger,original,savory portabella veggie burger,sun dried tomato basil burger,veggie medley burger
luncheon slices	meatless
tofu yogurt	
sandwich spread	meatless
silk plus omega three dha	soymilk
morningstar farms meal starters veggie meatballs	frozen,unprepared
loma linda big franks	canned,unprepared
chickpea flour	
morningstar farms entree chili	frozen,unprepared
worthington choplets	canned,unprepared
house foods premium firm tofu	
winged beans	mature seeds,raw,cooked,boiled,without salt,with salt
worthington wham	frozen,unprepared
