hot pockets ham 'n cheese stuffed sandwich	frozen
egg rolls	pork,refrigerated,heated,chicken,vegetable
corn dogs	frozen,prepared
pulled pork in barbecue sauce	
chili with beans	microwavable bowls
beef pot pie	frozen entree,prepared
lasagna with meat sauce	frozen,prepared
supper bakes meal kits	cheesy chicken with pasta,creamy stroganoff sauce with pasta,garlic chicken with pasta,herb chicken with rice,lemon chicken with herb rice,savory pork chops with herb stuffing,southwestern style chicken w/rice,traditional roast chicken with stuffing
pasta with tomato sauce	no meat,canned
chicken	nuggets,dark and white meat,precooked,frozen,not reheated,white meat
hot pockets	croissant pockets chicken,broccoli,and cheddar stuffed sandwich,frozen,meatballs & mozzarella stuffed sandwich
lasagna with meat & sauce	low fat,frozen entree
beef stew	canned entree
turkey	stuffing,mashed potatoes w/gravy,assorted vegetables,frozen,microwaved
pasta with meatballs in tomato sauce	canned entree
beef	corned beef hash,with potato,canned
spaghetti	with meatballs,canned
rice bowl with chicken	frozen entree,prepared
turkey pot pie	frozen entree
rice	chicken flavor,unprepared,prepared with eighty percent margarine,beef flavor,rice pilaf flavor
ravioli	cheese filled,canned,meat filled,with tomato sauce or meat sauce,cheese with tomato sauce,frozen,not prepared,includes regular and light entrees
pasta with sliced franks in tomato sauce	canned entree
spaghettios	mini beef ravioli in meat sauce,spaghetti in tomato & cheese sauce,spaghettios original,spaghettios  a to z's,spaghettios in meat sauce,spaghettios plus calcium,spaghettios raviolios beef ravioli in meat sauce,spaghettio's with meatballs,spaghettio's with sliced franks,spaghettios a to z's with meatballs,easy open,spaghettios  with meatballs   easy open
chicken tenders	breaded,frozen,prepared
lean pockets	ham n cheddar,meatballs & mozzarella
swanson	chicken a la king,chicken and dumplings
chili	no beans,canned entree
kashi	black bean mango,frozen entree,chicken and chipotle bbq sauce with mango,chicken enchilada with ancho sauce,steam meal,chicken fettuccine,chicken florentine,chicken pasta pomodoro,lemongrass coconut chicken,mayan harvest bake,pesto pasta primavera,pilaf,seven whole grain,red curry chicken,roasted garlic chicken farfalle,sesame chicken,southwest style chicken,spicy black bean enchilada,spinach artichoke pasta,sweet and sour chicken,three cheese penne,tuscan veggie bake
spaghetti with meat sauce	frozen entree
chili con carne with beans	canned entree
tortellini	pasta with cheese filling,fresh refrigerated,as purchased
burrito	beef and bean,frozen,bean and cheese,microwaved
potato salad with egg	
macaroni and cheese	canned entree,canned,microwavable,dry mix,prepared with two percent milk and eighty percent stick margarine from dry mix,frozen entree,box mix with cheese sauce,unprepared,prepared
lasagna	cheese,frozen,prepared,vegetable,baked
chicken pot pie	frozen entree,prepared
macaroni and cheese dinner with dry sauce mix	boxed,uncooked
