luxury loaf	pork
turkey and pork sausage	fresh,bulk,patty or link,cooked
chicken spread	
turkey ham	cured turkey thigh meat,sliced,extra lean,prepackaged or deli sliced
beef sausage	pre cooked,fresh,cooked
picnic loaf	pork,beef
polish sausage	pork
hormel wrangler beef franks	
macaroni and cheese loaf	chicken,pork and beef
barbecue loaf	pork,beef
salami	cooked,beef,beef and pork,turkey,dry or hard,pork,less sodium,italian,pork and beef,dry,sliced,fifty percent less sodium
hormel spam	luncheon meat,pork with ham,minced,canned,lite luncheon meat,pork and chicken,ascorbic acid added
chicken roll	light meat
frankfurter	beef,unheated,beef and pork,chicken,turkey,pork,and turkey,fat free,heated,meat,low fat,meat and poultry,low sodium
kielbasa	kolbassy,pork,beef,nonfat dry milk added,polish,turkey and beef,smoked
luncheon sausage	pork and beef
olive loaf	pork
ham and cheese loaf or roll	
pork and beef sausage	fresh,cooked
turkey	pork,and beef sausage,low fat,smoked,breast,lemon pepper flavor,ninety-seven percent fat free,white,rotisserie,deli cut,reduced fat
sausage	berliner,pork,beef,italian,raw,smoked link sausage,pork and beef,vienna,canned,chicken,cooked,sweet,links,polish,beef with chicken,hot,smoked,with cheddar cheese,summer,sticks,turkey,breakfast links,mild,skinless,chicken and beef
sandwich spread	pork,beef
ham	chopped,canned,not canned,sliced,prepackaged,regular,minced,honey,smoked,cooked
beef	cured,corned beef,canned,dried,luncheon meat,jellied,pastrami,sausage,cooked,smoked,chopped beef,thin sliced beef,bologna,reduced sodium
oscar mayer	bologna,bologna light,braunschweiger liver sausage,chicken breast,ham and cheese loaf,ham,head cheese,liver cheese,pork fat wrapped,luncheon loaf,old fashioned loaf,olive loaf,pickle pimiento loaf,pork sausage links,salami beef cotto,salami cotto,salami,sandwich spread,smokie links sausage,smokies,smokies sausage little,smokies sausage little cheese,summer sausage beef thuringer cervelat,summer sausage thuringer cervalat,turkey breast,wieners,wieners little
turkey roll	light and dark meat
corned beef loaf	jellied
bockwurst	pork,veal,raw
smoked link sausage	pork,pork and beef,flour and nonfat dry milk added,nonfat dry milk added
yachtwurst	with pistachio nuts,cooked
honey roll sausage	beef
brotwurst	pork,beef,link
bacon and beef sticks	
turkey sausage	reduced fat,brown and serve,cooked,fresh,raw
usda commodity	luncheon meat,canned,pork,sausage,bulk/links/patties,frozen,cooked,pork sausage,raw
peppered loaf	pork,beef
liver cheese	pork
turkey breast	low salt,prepackaged or deli,luncheon meat,sliced,oven roasted,prepackaged
pork sausage rice links	brown and serve,cooked
pastrami	turkey,beef,ninety-eight percent fat free
headcheese	pork
louis rich	chicken breast classic baked /grill,chicken breast,chicken,franks,turkey bacon,turkey bologna,turkey breast and white turkey,turkey,turkey breast,turkey ham,turkey nuggets/sticks,turkey salami,turkey salami cotto,turkey smoked sausage
cheesefurter	cheese smokie,pork,beef
butcher boy meats	inc.,turkey franks
carl buddig	cooked corned beef,chopped,pressed,smoked sliced chicken,light and dark meat,smoked sliced beef,smoked sliced turkey,smoked sliced ham
liverwurst spread	
liver sausage	liverwurst,pork
honey loaf	pork,beef
pate	chicken liver,canned,goose liver,smoked,liver,not specified,truffle flavor
lebanon bologna	beef
bratwurst	pork,cooked,veal,beef and pork,smoked,chicken,beef and turkey,lite
beerwurst	beer salami,pork and beef,pork
ham salad spread	
pork sausage	fresh,raw,cooked,pre cooked
carl buddig. cooked smoked beef pastrami	chopped,pressed
poultry salad sandwich spread	
ham and cheese spread	
luncheon meat	beef,loaved,thin sliced,pork,canned,ham,and chicken,minced,reduced sodium,added ascorbic acid,includes spam,twenty-five percent less sodium,pork with ham,pork and chicken,includes spam lite
knackwurst	knockwurst,pork,beef
mortadella	beef,pork
pickle and pimiento loaf	pork
mother's loaf	pork
scrapple	pork
roast beef spread	
thuringer	cervelat,summer sausage,beef,pork
chicken breast	fat free,mesquite flavor,sliced,oven roasted,deli,rotisserie seasoned,prepackaged
pork and turkey sausage	pre cooked
oscar mayer. bologna	
pepperoni	pork,beef
bologna	beef,beef and pork,pork,turkey,pork and turkey,lite,turkey and beef,chicken,low fat
blood sausage	
chorizo	pork and beef
swisswurst	pork and beef,with swiss cheese,smoked
oven roasted chicken breast roll	
braunschweiger	pork
new england brand sausage	pork,beef
hormel pillow pak sliced turkey pepperoni	
